F 90,120,80
C 135,206,235
SO ./texture/blue_flower.xpm
WE ./texture/red_flower.xpm
EA ./texture/green_flower.xpm
NO ./texture/red_flower.xpm


        1111111111111111111111111
        1000000000110000000000001
        101100000111000000000001
        1001000000000000000000001
111111111011000001110000000000001
100000000011000001110111111111111
11110111111111011100000010001
1111011111111101110101001001
11000000110101011100000010001
1000000000000001100000010001
10000000000000001101010010001
11000001110101011111011110N0111
11110111 1110101 101111010001
11111111 1111111 111111111111
