F 90,120,80
C 135,206,235
SO ./texture/snow1.xpm
WE ./texture/snow2.xpm
EA ./texture/snow3.xpm
NO ./texture/snow4.xpm

111111111111111111111111111111111
100000000000000000000000000000001
100000000000000000000000000000001
100000000000000000000000000000001
100000000000000000000000000000001
100000000000001111000000000000001
100000000000001111000000000000001
100000000000001111000000000000001
100000000000000000000000000000001
100000000000000000000000000000001
100000000000000N00000000000000001
100000000000000000000000000000001
100000000000000000000000000000001
111111111111111111111111111111111